'██     ██████ ██  ██ ██████ ██       ▄██▀▀▀  '
'██     ██▄▄   ██▄▄██ ██▄▄   ██       ██▄▄▄  ▀'
'██████ ██▄▄▄▄  ▀██▀  ██▄▄▄▄ ██████   ▀█▄▄█▀ ▄'
''
'█████▄ ▄████▄ ██     ▄████▄ ████▄  ██ ███  ██'
'██▄▄█▀ ██▄▄██ ██     ██▄▄██ ██  ██ ██ ██ ▀▄██'
'██     ██  ██ ██████ ██  ██ ████▀  ██ ██   ██'
